21111111117
11001111111
11111111111