11111111111
11E001P1C11
11111111111


1