11111111111
11001111111
11111111111