11111111111111
10001000000C01
100C0010110011
100P11E0000111
11111111111111