11111111111111
1E0010000E0C01
100C0010110011
100P11E0000111
11111111111111