11111111111111
1E0010000000C1
10000010110011
100P11E0000011
11111111111111