11111111111111
10010000000C11
10000111110011
1P0011EC000111
11111111111111
