11111111111111
1001000000FC11
10000111110011
1P0011EC000011
11111111111111
