11111111111111
10010000000C11
1000011111F011
1P0011EC000111
11111111111111
